10.ox
.ooo.ooo..
..oo.o.o.o
..........
o..o..oo..
ooo...o.o.
ooo..o.o.o
ooo....o..
oo..oooooo
o.o.o.o...
ooooo...oo
